R  918 468
NO ./textures/plants.xpm
SO ./textures/door3.xpm
XX ./textures/soil.xpm
EA ./textures/door.xpm

S ./textures/sprite.xpm

F 100,100,100
C 150,150,150

        1111111111111111111111111
        1000000000110000000000001
        1011000000000000000200001
        1001000000000000000000001
111111111011000001110000000000001
100000000011000000000001111111111
11110100000000001100000010001
11110100000000000000000010201
11000000110101011100000000001
10002000002000000020000000001
100000000000000W0000010000001
11000001110101011111011110001
11110111 1110101 101111010001
11111111 1111111 111111111111
